AcnR_Corynebacteriaceae	AcnR
AcnR_Frankineae_Propionibacterineae_Pseudonocardiaceae	AcnR
AcnR_Mycobacteriaceae	AcnR
AcnR_Nocardiaceae	AcnR
AgaR2_Enterobacteriales	AgaR
AgaR_Pasteurellales	AgaR
AgaR_Psychromonadaceae_Aeromonadales	AgaR
AgaR_Xanthomonadales	AgaR
AgaR_Vibrionales	AgaR
AgaR_Enterobacteriales	AgaR
AgaR_Shewanellaceae	AgaR
AmtR_Corynebacteriaceae	AmtR
AmtR_Micrococcineae	AmtR
AmtR_Mycobacteriaceae	AmtR
AmtR_Nocardiaceae	AmtR
AmtR_Streptomycetaceae	AmtR
AraR_Bacillales	AraR
AraR_Lactobacillaceae	AraR
AraR_Thermotogales	AraR
ArgR_Bifidobacteriaceae	ArgR
ArgR_Corynebacteriaceae	ArgR
ArgR_Frankineae_Propionibacterineae_Pseudonocardiaceae	ArgR
ArgR_Micrococcineae	ArgR
ArgR_Mycobacteriaceae	ArgR
ArgR_Nocardiaceae	ArgR
ArgR_Streptomycetaceae	ArgR
ArgR_Bacteroidaceae	ArgR
ArgR_Chlamydiales	ArgR
ArgR_Chlorobiales	ArgR
ArgR_Deinococcus-Thermus	ArgR
ArgR_Bacillales	ArgR
ArgR_Clostridia-1	ArgR
ArgR_Clostridia-3	ArgR
ArgR_Lactobacillaceae	ArgR
ArgR_Listeriaceae	ArgR
ArgR_Staphylococcaceae	ArgR
ArgR_Streptococcaceae	ArgR
ArgR_Thermoanaerobacterales	ArgR
ArgR_Francisellaceae	ArgR
ArgR_Alteromonadales	ArgR
ArgR_Enterobacteriales	ArgR
ArgR_Pasteurellales	ArgR
ArgR_Psychromonadaceae_Aeromonadales	ArgR
ArgR_Shewanellaceae	ArgR
ArgR_Vibrionales	ArgR
ArgR_Thermotogales	ArgR
BioQ_Actinomycetales	BioQ
BioQ_Corynebacteriaceae	BioQ
BioQ_Frankineae_Propionibacterineae_Pseudonocardiaceae	BioQ
BioQ_Micrococcineae	BioQ
BioQ_Mycobacteriaceae	BioQ
BioQ_Nocardiaceae	BioQ
BirA_Chlorobiales	BirA
BirA_Deinococcus-Thermus	BirA
BirA_Bacillales	BirA
BirA_Clostridia-1	BirA
BirA_Clostridia-2	BirA
BirA_Clostridia-3	BirA
BirA_Lactobacillaceae	BirA
BirA_Listeriaceae	BirA
BirA_Staphylococcaceae	BirA
BirA_Streptococcaceae	BirA
BirA_Thermoanaerobacterales	BirA
BirA_Pseudomonadaceae	BirA
BirA_Desulfovibrionales	BirA
BirA_Desulfuromonadales	BirA
BirA_Alteromonadales	BirA
BirA_Enterobacteriales	BirA
BirA_Oceanospirillales_Alteromonadales	BirA
BirA_Psychromonadaceae_Aeromonadales	BirA
BirA_Shewanellaceae	BirA
BirA_Various_betaproteobacteria	BirA
BirA_Vibrionales	BirA
BirA_Xanthomonadales	BirA
CadR-PbrR_Caulobacterales	CadR-PbrR
CadR-PbrR_Rhizobiales	CadR-PbrR
CadR-PbrR_Rhodobacterales	CadR-PbrR
CadR-PbrR_Rhodospirillales	CadR-PbrR
CadR-PbrR_Sphingomonadales	CadR-PbrR
CadR-PbrR_Burkholderia	CadR-PbrR
CadR-PbrR_Comamonadaceae	CadR-PbrR
CadR-PbrR_Ralstonia	CadR-PbrR
CadR-PbrR_Various_betaproteobacteria	CadR-PbrR
CadR-PbrR_Alteromonadales	CadR-PbrR
CadR-PbrR_Oceanospirillales_Alteromonadales	CadR-PbrR
CadR-PbrR_Pasteurellales	CadR-PbrR
CadR-PbrR_Pseudomonadaceae	CadR-PbrR
CadR-PbrR_Shewanellaceae	CadR-PbrR
CadR-PbrR_Desulfovibrionales	CadR-PbrR
CadR-PbrR_Desulfuromonadales	CadR-PbrR
CadR-PbrR_Moraxellaceae	CadR-PbrR
CadR-PbrR_Psychromonadaceae_Aeromonadales	CadR-PbrR
CblR_Sulfolobales	CblR
CblR_Thermoproteales	CblR
CblR_Halobacteriales	CblR
CblR_Thermococcales	CblR
CcpA_Bacillales	CcpA
CcpA_Clostridia-1	CcpA
CcpA_Clostridia-2	CcpA
CcpA_Lactobacillaceae	CcpA
CcpA_Staphylococcaceae	CcpA
CcpA_Streptococcaceae	CcpA
CsoR_Bifidobacteriaceae	CsoR
CsoR_Corynebacteriaceae	CsoR
CsoR_Micrococcineae	CsoR
CsoR_Nocardiaceae	CsoR
CsoR_Bacillales	CsoR
CsoR_Listeriaceae	CsoR
CueR_Comamonadaceae	CueR
CueR_Shewanellaceae	CueR
CueR_Caulobacterales	CueR
CueR_Rhizobiales	CueR
CueR_Rhodobacterales	CueR
CueR_Rhodospirillales	CueR
CueR_Sphingomonadales	CueR
CueR_Burkholderia	CueR
CueR_Ralstonia	CueR
CueR_Various_betaproteobacteria	CueR
CueR_Alteromonadales	CueR
CueR_Enterobacteriales	CueR
CueR_Moraxellaceae	CueR
CueR_Oceanospirillales_Alteromonadales	CueR
CueR_Pasteurellales	CueR
CueR_Pseudomonadaceae	CueR
CueR_Psychromonadaceae_Aeromonadales	CueR
CueR2_Shewanellaceae	CueR
CueR_Vibrionales	CueR
CueR_Xanthomonadales	CueR
CzrA_Bacillales	CzrA
CzrA_Clostridia-1	CzrA
CzrA_Clostridia-3	CzrA
CzcR1_Lactobacillaceae	CzrA
CzcR2_Lactobacillaceae	CzrA
CzrA_Listeriaceae	CzrA
CzrA_Staphylococcaceae	CzrA
DasR_Frankineae_Propionibacterineae_Pseudonocardiaceae	DasR
DasR_Micrococcineae	DasR
DasR_Nocardiaceae	DasR
DasR_Streptomycetaceae	DasR
UxuR_Oceanospirillales_Alteromonadales	ExuR_UxuR
UxuR_Pasteurellales	ExuR_UxuR
UxuR_Rhodobacterales	ExuR_UxuR
ExuR_Enterobacteriales	ExuR_UxuR
UxuR_Enterobacteriales	ExuR_UxuR
UxuR_Psychromonadaceae_Aeromonadales	ExuR_UxuR
UxuR_Vibrionales	ExuR_UxuR
FabR_Alteromonadales	FabR
FabR_Enterobacteriales	FabR
FabR_Moraxellaceae	FabR
FabR_Oceanospirillales_Alteromonadales	FabR
FabR2_Oceanospirillales_Alteromonadales	FabR
FabR_Pasteurellales	FabR
DesT_Pseudomonadaceae	FabR
FabR2_Pseudomonadaceae	FabR
FabR_Psychromonadaceae_Aeromonadales	FabR
FabR_Shewanellaceae	FabR
FabR_Vibrionales	FabR
FabR_Xanthomonadales	FabR
FadP_Burkholderia	FadP
FadP_Comamonadaceae	FadP
FadP_Ralstonia	FadP
FadR_Alteromonadales	FadR
FadR_Enterobacteriales	FadR
FadR_Pasteurellales	FadR
FadR_Psychromonadaceae_Aeromonadales	FadR
FadR_Shewanellaceae	FadR
FadR_Vibrionales	FadR
FixJ_A-Rhizobiales	FixJ
FixJ_Caulobacterales	FixJ
FixJ_a-Rhizobiales	FixJ
FnrN_FixK_AadR_Rhizobiales	FnrN_FixK
FixK_Caulobacterales	FnrN_FixK
FnrN_Rhodobacterales	FnrN_FixK
FnrN_Rhodospirillales	FnrN_FixK
FnrN_Sphingomonadales	FnrN_FixK
FruR_Oceanospirillales_Alteromonadales	FruR
FruR_Enterobacteriales	FruR
FruR_Pasteurellales	FruR
FruR_Pseudomonadaceae	FruR
FruR_Psychromonadaceae_Aeromonadales	FruR
FruR_Vibrionales	FruR
Fur_Bacteroidaceae	FUR
Fur_Cyanobacteria	FUR
Fur_Bacillales	FUR
Fur_Clostridia-2	FUR
Fur_Clostridia-3	FUR
Fur_Enterococcaceae	FUR
Fur_Listeriaceae	FUR
Fur_Staphylococcaceae	FUR
Fur_Thermoanaerobacterales	FUR
Fur_Caulobacterales	FUR
Fur_Pasteurellales	FUR
Mur_Rhizobiales	FUR
Mur_Rhodobacterales	FUR
Fur_Rhodospirillales	FUR
Fur_Shewanellaceae	FUR
Fur_Sphingomonadales	FUR
Fur_Rhodobacterales	FUR
Fur_Alteromonadales	FUR
Fur_Psychromonadaceae_Aeromonadales	FUR
Fur_Vibrionales	FUR
Fur_Xanthomonadales	FUR
Fur_Ralstonia	FUR
Fur_Desulfovibrionales	FUR
Fur_Desulfuromonadales	FUR
Fur_Enterobacteriales	FUR
Fur_Thermotogales	FUR
GguR_Burkholderia	GguR
GguR_Comamonadaceae	GguR
GguR_Ralstonia	GguR
GguR_Pseudomonadaceae	GguR
GlcC_Burkholderia	GlcC
GlcC_Enterobacteriales	GlcC
GlcC_Oceanospirillales_Alteromonadales	GlcC
GlcC_Pseudomonadaceae	GlcC
GlcC_Rhizobiales	GlcC
GlcC_Rhodobacterales	GlcC
GlcC_Various_betaproteobacteria	GlcC
GntR_Rhizobiales	GntR
GntR_Rhodospirillales	GntR
GntR_Burkholderia	GntR
GntR_Comamonadaceae	GntR
GntR_Various_betaproteobacteria	GntR
GntR_Alteromonadales	GntR
GntR_Enterobacteriales  	GntR
GntR_Oceanospirillales_Alteromonadales	GntR
GntR_Pasteurellales	GntR
GntR_Pseudomonadaceae	GntR
GntR_Psychromonadaceae_Aeromonadales	GntR
GntR_Shewanellaceae	GntR
GntR_Vibrionales	GntR
GulR_Rhizobiales	GulR
GulR_Ralstonia	GulR
GulR_Xanthomonadales	GulR
HcpR_Bacteroidaceae	HcpR
HcpR_Chloroflexia	HcpR
HcpR_Clostridia-1	HcpR
HcpR_Clostridia-2	HcpR
HcpR_Thermoanaerobacterales	HcpR
HcpR_Desulfovibrionales	HcpR
HcpR_Desulfuromonadales	HcpR
HcpR_Thermotogales	HcpR
HexR_Burkholderia	HexR
HexR_Comamonadaceae	HexR
HexR_Ralstonia	HexR
HexR_Various_betaproteobacteria	HexR
HexR_Alteromonadales	HexR
HexR_Enterobacteriales	HexR
HexR_Oceanospirillales_Alteromonadales	HexR
HexR2_Oceanospirillales_Alteromonadales	HexR
HexR_Pseudomonadaceae	HexR
HexR1_Pseudomonadaceae	HexR
HexR_Psychromonadaceae_Aeromonadales	HexR
HexR_Shewanellaceae	HexR
HexR_Vibrionales	HexR
HisR_Bacillales	HisR
HisR_Clostridia-3	HisR
HisR_Listeriaceae	HisR
HisR_Staphylococcaceae	HisR
HisR_Thermoanaerobacterales	HisR
HisR_Xanthomonadales	HisR
HrcA_Bifidobacteriaceae	HrcA
HrcA_Corynebacteriaceae	HrcA
HrcA_Frankineae_Propionibacterineae_Pseudonocardiaceae	HrcA
HrcA_Micrococcineae	HrcA
HrcA_Mycobacteriaceae	HrcA
HrcA_Nocardiaceae	HrcA
HrcA_Streptomycetaceae	HrcA
HrcA_Chlamydiales	HrcA
HrcA_Chlorobiales	HrcA
HrcA_Chloroflexia	HrcA
HrcA_Cyanobacteria	HrcA
HrcA_Deinococcus-Thermus	HrcA
HrcA_Bacillales	HrcA
HrcA_Clostridia-1	HrcA
HrcA_Clostridia-2	HrcA
HrcA_Clostridia-3	HrcA
HrcA_Lactobacillaceae	HrcA
HrcA_Listeriaceae	HrcA
HrcA_Staphylococcaceae	HrcA
HrcA_Streptococcaceae	HrcA
HrcA_Thermoanaerobacterales	HrcA
HrcA_Caulobacterales	HrcA
HrcA_Rhizobiales	HrcA
HrcA_Rhodobacterales	HrcA
HrcA_Rhodospirillales	HrcA
HrcA_Sphingomonadales	HrcA
HrcA_Alcaligenaceae	HrcA
HrcA_Burkholderia	HrcA
HrcA_Comamonadaceae	HrcA
HrcA_Ralstonia	HrcA
HrcA_Various_betaproteobacteria	HrcA
HrcA_Desulfovibrionales	HrcA
HrcA_Desulfuromonadales	HrcA
HrcA_Alteromonadales	HrcA
HrcA_Oceanospirillales_Alteromonadales	HrcA
HrcA_Xanthomonadales	HrcA
HrcA_Thermotogales	HrcA
HutC_Caulobacterales	HutC
HutC_Rhizobiales	HutC
HutC_Rhodobacterales	HutC
HutC_Rhodospirillales	HutC
HutC_Sphingomonadales	HutC
HutC_Burkholderia	HutC
HutC_Comamonadaceae	HutC
HutC_Ralstonia	HutC
HutC_Various_betaproteobacteria	HutC
HutC_Alteromonadales	HutC
HutC_Enterobacteriales	HutC
HutC_Moraxellaceae	HutC
HutC_Oceanospirillales_Alteromonadales	HutC
HutC_Pseudomonadaceae	HutC
HutC_Psychromonadaceae_Aeromonadales	HutC
HutC_Shewanellaceae	HutC
HutC_Vibrionales	HutC
HutC_Xanthomonadales	HutC
HypR_Rhizobiales	HypR
HypR_Rhodobacterales	HypR
HypR2_Rhodobacterales	HypR
HypR_Rhodospirillales	HypR
HypR_Burkholderia	HypR
HypR_Ralstonia	HypR
HypR_Alteromonadales	HypR
HypR_Enterobacteriales	HypR
HypR_Oceanospirillales_Alteromonadales	HypR
HypR_Pseudomonadaceae	HypR
HypR_Psychromonadaceae_Aeromonadales	HypR
HypR_Shewanellaceae	HypR
HypR_Vibrionales	HypR
Irr_Rhizobiales	Irr
Irr_Rhodobacterales	Irr
Irr_Rhodospirillales	Irr
IscR_Alteromonadales	IscR
IscR_Burkholderia	IscR
IscR_Caulobacterales	IscR
IscR_Comamonadaceae	IscR
IscR_Desulfuromonadales	IscR
IscR_Moraxellaceae	IscR
IscR_Oceanospirillales_Alteromonadales	IscR
IscR_Pasteurellales	IscR
IscR_Pseudomonadaceae	IscR
IscR_Psychromonadaceae_Aeromonadales	IscR
IscR_Rhodospirillales	IscR
IscR2_Rhodospirillales	IscR
IscR_Sphingomonadales	IscR
IscR_Various_betaproteobacteria	IscR
IscR_Vibrionales	IscR
IscR_Xanthomonadales	IscR
IscR_Rhodobacterales	IscR
IscR_Ralstonia	IscR
IscR_Enterobacteriales	IscR
IscR_Shewanellaceae	IscR
KdgR_Enterobacteriales	KdgR
KdgR_Pasteurellales	KdgR
KdgR_Vibrionales	KdgR
KdgR_Thermotogales	KdgR
LexA_Bifidobacteriaceae	LexA
LexA_Corynebacteriaceae	LexA
LexA_Frankineae_Propionibacterineae_Pseudonocardiaceae	LexA
LexA_Micrococcineae	LexA
LexA_Mycobacteriaceae	LexA
LexA_Nocardiaceae	LexA
LexA_Streptomycetaceae	LexA
LexA_Chloroflexia	LexA
LexA_Cyanobacteria	LexA
LexA_Bacillales	LexA
LexA_Clostridia-1	LexA
LexA_Clostridia-2	LexA
LexA_Clostridia-3	LexA
LexA_Lactobacillaceae	LexA
LexA_Listeriaceae	LexA
LexA_Staphylococcaceae	LexA
LexA_Planctomycetes	LexA
LexA_Desulfuromonadales	LexA
LexA_Rhodobacterales	LexA
LexA_Caulobacterales	LexA
LexA_Rhizobiales	LexA
LexA_Rhodospirillales	LexA
LexA_Sphingomonadales	LexA
LexA_Alcaligenaceae	LexA
LexA_Burkholderia	LexA
LexA_Comamonadaceae	LexA
LexA_Ralstonia	LexA
LexA_Various_betaproteobacteria	LexA
LexA_Desulfovibrionales	LexA
LexA_Alteromonadales	LexA
LexA_Enterobacteriales_	LexA
LexA_Oceanospirillales_Alteromonadales	LexA
LexA_Pasteurellales	LexA
LexA_Pseudomonadaceae	LexA
LexA_Psychromonadaceae_Aeromonadales	LexA
LexA_Shewanellaceae	LexA
LexA_Vibrionales	LexA
LexA_Xanthomonadales	LexA
LexA2_Xanthomonadales	LexA
LiuQ_Burkholderia	LiuQ
LiuQ_Comamonadaceae	LiuQ
LiuQ_Ralstonia	LiuQ
LiuR_Caulobacterales	LiuR
LiuR_Rhizobiales	LiuR
LiuR_Rhodobacterales	LiuR
LiuR_Rhodospirillales	LiuR
LiuR_Sphingomonadales	LiuR
LiuR_Burkholderia	LiuR
LiuR_Comamonadaceae	LiuR
LiuR2_Comamonadaceae	LiuR
LiuR_Ralstonia	LiuR
LiuR_Various_betaproteobacteria	LiuR
LiuR_Alteromonadales	LiuR
LiuR_Oceanospirillales_Alteromonadales	LiuR
LiuR_Pseudomonadaceae	LiuR
LiuR_Psychromonadaceae_Aeromonadales	LiuR
LiuR_Shewanellaceae	LiuR
LiuR_Vibrionales	LiuR
LldR_Corynebacteriaceae	LldR
LldR_Rhizobiales	LldR
LldR_Rhodobacterales	LldR
LldR_Rhodospirillales	LldR
LldR_Burkholderia	LldR
LldR_Comamonadaceae	LldR
LldR_Ralstonia	LldR
LldR_Various_betaproteobacteria	LldR
LldR_Desulfovibrionales	LldR
LldR_Desulfuromonadales	LldR
LldR_Enterobacteriales	LldR
LldR_Moraxellaceae	LldR
LldR_Oceanospirillales_Alteromonadales	LldR
LldR_Pseudomonadaceae	LldR
LldR_Xanthomonadales	LldR
LtbR_Nocardiaceae_	LtbR
LtbR_Bifidobacteriaceae	LtbR
LtbR_Corynebacteriaceae	LtbR
LtbR_Frankineae_Propionibacterineae_Pseudonocardiaceae	LtbR
LtbR_Micrococcineae	LtbR
LtbR_Mycobacteriaceae	LtbR
LtbR_Streptomycetaceae	LtbR
MerR_Rhizobiales	MerR
MerR_Sphingomonadales	MerR
MerR_Burkholderia	MerR
MerR_Comamonadaceae	MerR
MerR_Ralstonia	MerR
MerR_Various_betaproteobacteria	MerR
MerR_Alteromonadales	MerR
MerR_Oceanospirillales_Alteromonadales	MerR
MerR_Psychromonadaceae_Aeromonadales	MerR
MerR_Shewanellaceae	MerR
MerR_Rhodobacterales	MerR
MerR_Pseudomonadaceae	MerR
MerR_Xanthomonadales	MerR
MetJ_Alteromonadales	MetJ
MetJ_Enterobacteriales	MetJ
MetJ_Pasteurellales	MetJ
MetJ_Psychromonadaceae_Aeromonadales	MetJ
MetJ_Vibrionales	MetJ
MetJ_Shewanellaceae	MetJ
MetR_Rhodobacterales	MetR
MetR_Alcaligenaceae	MetR
MetR_Burkholderia	MetR
MetR_Ralstonia	MetR
MetR_Alteromonadales	MetR
MetR_Enterobacteriales	MetR
MetR_Oceanospirillales_Alteromonadales	MetR
MetR_Pasteurellales	MetR
MetR_Pseudomonadaceae	MetR
MetR_Psychromonadaceae_Aeromonadales	MetR
MetR_Shewanellaceae	MetR
MetR_Vibrionales	MetR
MetR_Comamonadaceae	MetR
MetR_Various_betaproteobacteria	MetR
MetR_Xanthomonadales	MetR
MntR_Corynebacteriaceae	MntR
MntR_Micrococcineae	MntR
MntR_Mycobacteriaceae	MntR
MntR_Nocardiaceae	MntR
MntR_Chloroflexia	MntR
MntR_Bacillales	MntR
MntR_Clostridia-1	MntR
MntR_Enterococcaceae	MntR
MntR_Lactobacillaceae	MntR
MntR_Listeriaceae	MntR
MntR_Staphylococcaceae	MntR
MntR_Streptococcaceae	MntR
MntR_Rhizobiales	MntR
MntR_Rhodobacterales	MntR
MntR_Rhodospirillales	MntR
MntR_Enterobacteriales	MntR
MntR_Xanthomonadales	MntR
ModE2_Flavobacteria	ModE
ModE_Chlorobiales	ModE
ModE_A-Rhizobiales	ModE
ModE_Rhodobacterales	ModE
ModE3_Alcaligenaceae	ModE
ModE2_Burkholderia	ModE
ModE2_Comamonadaceae	ModE
ModE3_Comamonadaceae	ModE
ModE3_Ralstonia	ModE
ModE2_Various_betaproteobacteria	ModE
ModE_Caulobacterales	ModE
ModE_a-Rhizobiales	ModE
ModE2_Rhodobacterales	ModE
ModE_Rhodospirillales	ModE
ModE2_Rhodospirillales	ModE
ModE2_Sphingomonadales	ModE
ModE_Alcaligenaceae	ModE
ModE_Burkholderia	ModE
ModE_Comamonadaceae	ModE
ModE_Ralstonia	ModE
ModE_Various_betaproteobacteria	ModE
ModE2_Desulfovibrionales	ModE
ModE_Desulfuromonadales	ModE
ModE_Enterobacteriales	ModE
ModE_Moraxellaceae	ModE
ModE_Oceanospirillales_Alteromonadales	ModE
ModE_Pasteurellales	ModE
ModE_Pseudomonadaceae	ModE
ModE_Psychromonadaceae_Aeromonadales	ModE
ModE_Shewanellaceae	ModE
ModE_Vibrionales	ModE
NadQ_Caulobacterales	NadQ
NadQ_Rhizobiales	NadQ
NadQ_Rhodobacterales	NadQ
NadQ_Rhodospirillales	NadQ
NadQ_Comamonadaceae	NadQ
NadQ_Various_betaproteobacteria	NadQ
NadQ_Moraxellaceae	NadQ
NagC_Enterobacteriales	NagC
NagC_Oceanospirillales_Alteromonadales	NagC
NagC_Pasteurellales	NagC
NagC_Psychromonadaceae_Aeromonadales	NagC
NagC_Vibrionales	NagC
NagQ_Caulobacterales	NagQ
NagQ_Rhizobiales	NagQ
NagQ_Rhodobacterales	NagQ
NagQ_Rhodospirillales	NagQ
NagQ_Burkholderia	NagQ
NagQ_Ralstonia	NagQ
NagQ_Various_betaproteobacteria	NagQ
NagQ_Oceanospirillales_Alteromonadales	NagQ
NagQ_Pseudomonadaceae	NagQ
NagQ_Xanthomonadales	NagQ
GenR_Corynebacteriaceae	NagR
NagR_Bacillales	NagR
NagR_Streptococcaceae	NagR
NagR_Alteromonadales	NagR
NagR_Oceanospirillales_Alteromonadales	NagR
NagR_Shewanellaceae	NagR
NagR_Xanthomonadales	NagR
NarP_Pasteurellales	NarP
NarP_Psychromonadaceae_Aeromonadales	NarP
NarP_Shewanellaceae	NarP
NarP_Vibrionales	NarP
NarP_Enterobacteriales	NarP
NiaR_Bacillales	NiaR
NiaR_Lactobacillaceae	NiaR
NiaR_Streptococcaceae	NiaR
NiaR_Thermotogales	NiaR
NifA_Rhizobiales	NifA
NifA_Rhodobacterales	NifA
NifA_Rhodospirillales	NifA
NifA_Sphingomonadales	NifA
NikR_Chlorobiales	NikR
NikR_Thermoanaerobacterales	NikR
NikR_Rhizobiales	NikR
NikR_Rhodobacterales	NikR
NikR_Rhodospirillales	NikR
NikR_Burkholderia	NikR
NikR_Comamonadaceae	NikR
NikR_Various_betaproteobacteria	NikR
NikR_Desulfovibrionales	NikR
NikR_Desulfuromonadales	NikR
NikR_Enterobacteriales	NikR
NikR_Pseudomonadaceae	NikR
NikR_Shewanellaceae	NikR
NmlR_Burkholderia	NmlR
NmlR_Comamonadaceae	NmlR
NmlR_Various_betaproteobacteria	NmlR
NmlR_Pasteurellales	NmlR
NmlR_Shewanellaceae	NmlR
NmlR_Rhizobiales	NmlR
NmlR_Ralstonia	NmlR
NmlR_Alteromonadales	NmlR
NmlR_Pseudomonadaceae	NmlR
NmlR_Vibrionales	NmlR
NmlR_Xanthomonadales	NmlR
NnrR_Caulobacterales	NnrR
NnrR_Rhizobiales	NnrR
NnrR_Rhodobacterales	NnrR
NnrR_Rhodospirillales	NnrR
NnrR_Sphingomonadales	NnrR
NorR_Burkholderia	NorR
NorR_Comamonadaceae	NorR
NorR_Ralstonia	NorR
NorR_Alteromonadales	NorR
NorR_Enterobacteriales	NorR
NorR_Oceanospirillales_Alteromonadales	NorR
NorR_Pseudomonadaceae	NorR
NorR_Psychromonadaceae_Aeromonadales	NorR
NorR_Shewanellaceae	NorR
NorR_Vibrionales	NorR
NorR2_Vibrionales	NorR
NrdR_Bifidobacteriaceae	NrdR
NrdR_Corynebacteriaceae	NrdR
NrdR_Frankineae_Propionibacterineae_Pseudonocardiaceae	NrdR
NrdR_Micrococcineae	NrdR
NrdR_Mycobacteriaceae	NrdR
NrdR_Nocardiaceae	NrdR
NrdR_Streptomycetaceae	NrdR
NrdR_Chlamydiales	NrdR
NrdR_Chloroflexia	NrdR
NrdR_Cyanobacteria	NrdR
NrdR_Deinococcus-Thermus	NrdR
NrdR_Bacillales	NrdR
NrdR_Clostridia-1	NrdR
NrdR_Clostridia-2	NrdR
NrdR_Clostridia-3	NrdR
NrdR_Lactobacillaceae	NrdR
NrdR_Listeriaceae	NrdR
NrdR_Staphylococcaceae	NrdR
NrdR_Streptococcaceae	NrdR
NrdR_Thermoanaerobacterales	NrdR
NrdR_Planctomycetes	NrdR
NrdR_Alcaligenaceae	NrdR
NrdR_Caulobacterales	NrdR
NrdR_Rhizobiales	NrdR
NrdR_Rhodobacterales	NrdR
NrdR_Rhodospirillales	NrdR
NrdR_Sphingomonadales	NrdR
NrdR_Burkholderia	NrdR
NrdR_Comamonadaceae	NrdR
NrdR_Ralstonia	NrdR
NrdR_Various_betaproteobacteria	NrdR
NrdR_Desulfuromonadales	NrdR
NrdR_Alteromonadales	NrdR
NrdR_Enterobacteriales	NrdR
NrdR_Moraxellaceae	NrdR
NrdR_Oceanospirillales_Alteromonadales	NrdR
NrdR_Pasteurellales	NrdR
NrdR_Pseudomonadaceae	NrdR
NrdR_Psychromonadaceae_Aeromonadales	NrdR
NrdR_Shewanellaceae	NrdR
NrdR_Vibrionales	NrdR
NrdR_Xanthomonadales	NrdR
NrdR_Thermotogales	NrdR
NrtR_Bifidobacteriaceae	NrtR
NrtR_Corynebacteriaceae	NrtR
NrtR_Frankineae_Propionibacterineae_Pseudonocardiaceae	NrtR
NrtR_Micrococcineae	NrtR
NrtR_Mycobacteriaceae	NrtR
NrtR_Nocardiaceae	NrtR
NrtR_Streptomycetaceae	NrtR
NrtR_Flavobacteria	NrtR
NrtR_Sphingobacteria	NrtR
NrtR_Chloroflexia	NrtR
NrtR_Cyanobacteria	NrtR
NrtR2_Cyanobacteria	NrtR
NrtR_Clostridia-1	NrtR
NrtR_Lactobacillaceae	NrtR
NrtR_Streptococcaceae	NrtR
NrtR_Rhizobiales	NrtR
NrtR_Rhodobacterales	NrtR
NrtR_Comamonadaceae	NrtR
NrtR_Various_betaproteobacteria	NrtR
NrtR_Enterobacteriales	NrtR
NrtR_Moraxellaceae	NrtR
NrtR_Oceanospirillales_Alteromonadales	NrtR
NrtR_Pseudomonadaceae	NrtR
NrtR_Psychromonadaceae_Aeromonadales	NrtR
NrtR_Shewanellaceae	NrtR
NrtR_Vibrionales	NrtR
NsrR_Bacillales	NsrR
NsrR_Caulobacterales	NsrR
NsrR_Rhizobiales	NsrR
NsrR_Rhodobacterales	NsrR
NsrR_Rhodospirillales	NsrR
NsrR_Sphingomonadales	NsrR
NsrR_Burkholderia	NsrR
NsrR_Comamonadaceae	NsrR
NsrR_Neisseriales	NsrR
NsrR_Ralstonia	NsrR
NsrR2_Various_betaproteobacteria	NsrR
NsrR_Alteromonadales	NsrR
NsrR_Enterobacteriales	NsrR
NsrR_Moraxellaceae	NsrR
NsrR_Oceanospirillales_Alteromonadales	NsrR
NsrR_Psychromonadaceae_Aeromonadales	NsrR
NsrR_Shewanellaceae	NsrR
NsrR_Vibrionales	NsrR
NtrC_Caulobacterales	NtrC
NtrC_Desulfuromonadales	NtrC
NtrC_Rhizobiales	NtrC
NtrC_Rhodobacterales	NtrC
NtrC_Rhodospirillales	NtrC
NtrC_Sphingomonadales	NtrC
NtrC_Burkholderia	NtrC
NtrC_Comamonadaceae	NtrC
NtrC_Ralstonia	NtrC
NtrC_Various_betaproteobacteria	NtrC
NtrC_Alteromonadales	NtrC
NtrC_Enterobacteriales_	NtrC
NtrC_Moraxellaceae	NtrC
NtrC_Oceanospirillales_Alteromonadales	NtrC
NtrC_Pseudomonadaceae	NtrC
NtrC_Psychromonadaceae_Aeromonadales	NtrC
NtrC_Shewanellaceae	NtrC
NtrC_Vibrionales	NtrC
NtrC_Xanthomonadales	NtrC
PaaR_Actinobacteria	PaaR
PaaR_Corynebacteriaceae	PaaR
PaaR_Frankineae_Propionibacterineae_Pseudonocardiaceae	PaaR
PaaR_Micrococcineae	PaaR
PaaR_Mycobacteriaceae	PaaR
PaaR_Nocardiaceae	PaaR
PaaR_Streptomycetaceae	PaaR
PaaR_Rhizobiales	PaaR
PaaR_Rhodobacterales	PaaR
PaaR_Flavobacteria	PaaR
PaaR_Burkholderia	PaaR
PaaR_Comamonadaceae	PaaR
PaaR_Ralstonia	PaaR
PaaR_Deinococcus-Thermus	PaaR
PaaR2_Deinococcus-Thermus	PaaR
PdhR_Alteromonadales	PdhR
PdhR_Enterobacteriales	PdhR
PdhR_Oceanospirillales_Alteromonadales	PdhR
PdhR_Psychromonadaceae_Aeromonadales	PdhR
PdhR_Shewanellaceae	PdhR
PdhR_Vibrionales	PdhR
PdxR_Corynebacteriaceae	PdxR
PdxR_Frankineae_Propionibacterineae_Pseudonocardiaceae	PdxR
PdxR2_Frankineae_Propionibacterineae_Pseudonocardiaceae	PdxR
PdxR3_Frankineae_Propionibacterineae_Pseudonocardiaceae	PdxR
PdxR3_Micrococcineae	PdxR
PdxR_Micrococcineae	PdxR
PdxR2_Micrococcineae	PdxR
PdxR2_Mycobacteriaceae	PdxR
PdxR3_Mycobacteriaceae	PdxR
PdxR2_Nocardiaceae	PdxR
PdxR3_Nocardiaceae	PdxR
PdxR3_Streptomycetaceae	PdxR
PdxR2_Deinococcus-Thermus	PdxR
PdxR_Bacillales	PdxR
PdxR_Clostridia-3	PdxR
PdxR_Enterococcaceae	PdxR
PdxR_Lactobacillaceae	PdxR
PdxR_Listeriaceae	PdxR
PdxR_Staphylococcaceae	PdxR
PdxR_Streptococcaceae	PdxR
PdxR_Thermoanaerobacterales	PdxR
PdxR3_Caulobacterales	PdxR
PdxR_Rhizobiales	PdxR
PdxR2_Rhizobiales	PdxR
PdxR2_Rhodobacterales	PdxR
PdxR3_Rhodobacterales	PdxR
PdxR_Rhodospirillales	PdxR
PdxR2_Sphingomonadales	PdxR
PdxR_Alcaligenaceae	PdxR
PdxR2_Alcaligenaceae	PdxR
PdxR_Comamonadaceae	PdxR
PdxR3_Comamonadaceae	PdxR
PdxR2_Ralstonia	PdxR
PdxR_Various_betaproteobacteria	PdxR
PdxR_Enterobacteriales	PdxR
PdxR2_Enterobacteriales	PdxR
PdxR3_Enterobacteriales	PdxR
PdxR_Pasteurellales	PdxR
PdxR_Pseudomonadaceae	PdxR
PdxR2_Xanthomonadales	PdxR
PhnF_Burkholderia	PhnF
PhnF_Comamonadaceae	PhnF
PhnF_Oceanospirillales_Alteromonadales	PhnF
PhnF_Pseudomonadaceae	PhnF
PhnF_Psychromonadaceae_Aeromonadales	PhnF
PhnF_Rhizobiales	PhnF
PhnF_Rhodobacterales	PhnF
PhnF_Various_betaproteobacteria	PhnF
PhnF_Ralstonia	PhnF
PhnF_Desulfovibrionales	PhnF
PhnF_Enterobacteriales	PhnF
PhnR2_Burkholderia	PhnR
PhnR2_Comamonadaceae	PhnR
PhnR2_Ralstonia	PhnR
PhnR1_Enterobacteriales	PhnR
PhnR1_Psychromonadaceae_Aeromonadales	PhnR
PhnR_Caulobacterales	PhnR
PhnR_Enterobacteriales	PhnR
PhnR_Moraxellaceae	PhnR
PhnR_Oceanospirillales_Alteromonadales	PhnR
PhnR_Pseudomonadaceae	PhnR
PhnR_Psychromonadaceae_Aeromonadales	PhnR
PhnR_Vibrionales	PhnR
Phr_Archaeoglobales	Phr
Phr_Methanobacteriales	Phr
Phr_Methanomicrobiales	Phr
Phr_Methanosarcinales	Phr
Phr_Thermococcales	Phr
PhrR_Pseudomonadaceae	PhrR
PhrR_Psychromonadaceae_Aeromonadales	PhrR
PhrR_Shewanellaceae	PhrR
PhrR_Vibrionales	PhrR
PhsR_Shewanellaceae	PhsR
PhsR_Vibrionales	PhsR
PrpR_Comamonadaceae	PrpR
PrpR_Desulfuromonadales	PrpR
PrpR_Alteromonadales	PrpR
PrpR_Moraxellaceae	PrpR
PrpR_Oceanospirillales_Alteromonadales	PrpR
PrpR_Pseudomonadaceae	PrpR
PrpR_Psychromonadaceae_Aeromonadales	PrpR
PrpR_Shewanellaceae	PrpR
PrpR_Vibrionales	PrpR
PsrA_Caulobacterales	PsrA
PsrA_Rhizobiales	PsrA
PsrA_Burkholderia	PsrA
PsrA_Ralstonia	PsrA
PsrA_Various_betaproteobacteria	PsrA
PsrA_Alteromonadales	PsrA
PsrA_Oceanospirillales_Alteromonadales	PsrA
PsrA_Pseudomonadaceae	PsrA
PsrA_Psychromonadaceae_Aeromonadales	PsrA
PsrA_Shewanellaceae	PsrA
PsrA_Vibrionales	PsrA
PsrA_Xanthomonadales	PsrA
PurR_Enterobacteriales	PurR
PurR_Pasteurellales	PurR
PurR_Vibrionales	PurR
QorR_Corynebacteriaceae	QorR
QorR_Frankineae_Propionibacterineae_Pseudonocardiaceae	QorR
QorR_Micrococcineae	QorR
QorR_Nocardiaceae	QorR
QorR_Streptomycetaceae	QorR
QorR_Enterobacteriales	QorR
RbkR_Sulfolobales	RbkR
RbkR_Thermoproteales	RbkR
RbkR_Archaeoglobales	RbkR
RbkR_Halobacteriales	RbkR
RbkR_Methanomicrobiales	RbkR
RbkR_Methanosarcinales	RbkR
RbkR_Thermococcales	RbkR
RbkR_Thermoplasmatales	RbkR
RbsR_Bacillales	RbsR
RbsR_Staphylococcaceae	RbsR
RbsR2_Staphylococcaceae	RbsR
RbsR_Burkholderia	RbsR
RbsR_Comamonadaceae	RbsR
RbsR_Ralstonia	RbsR
RbsR_Desulfovibrionales	RbsR
RbsR_Enterobacteriales	RbsR
RbsR_Pasteurellales	RbsR
RbsR_Pseudomonadaceae	RbsR
RbsR_Psychromonadaceae_Aeromonadales	RbsR
RbsR_Shewanellaceae	RbsR
RbsR_Vibrionales	RbsR
RbsR_Thermotogales	RbsR
Rex_Actinomycetales	Rex
Rex_Frankineae_Propionibacterineae_Pseudonocardiaceae	Rex
Rex_Micrococcineae	Rex
Rex_Nocardiaceae	Rex
Rex_Streptomycetaceae	Rex
Rex_Chloroflexia	Rex
Rex_Deinococcus-Thermus	Rex
Rex_Bacillales	Rex
Rex_Clostridia-1	Rex
Rex_Lactobacillaceae	Rex
Rex_Staphylococcaceae	Rex
Rex_Streptococcaceae	Rex
Rex_Thermoanaerobacterales	Rex
Rex_Desulfovibrionales	Rex
Rex_Thermotogales	Rex
Rex1_Thermotogales	Rex
RutR_Caulobacterales	RutR
RutR_Rhizobiales	RutR
RutR_Rhodobacterales	RutR
RutR_Rhodospirillales	RutR
RutR_Burkholderia	RutR
RutR_Ralstonia	RutR
RutR_Alteromonadales	RutR
RutR2_Alteromonadales	RutR
RutR_Enterobacteriales	RutR
RutR_Moraxellaceae	RutR
RutR_Oceanospirillales_Alteromonadales	RutR
RutR_Pseudomonadaceae	RutR
RutR2_Pseudomonadaceae	RutR
RutR3_Pseudomonadaceae	RutR
RutR4_Pseudomonadaceae	RutR
RutR_Psychromonadaceae_Aeromonadales	RutR
RutR_Vibrionales	RutR
SahR_Caulobacterales	SahR_SamR
SahR_Rhizobiales	SahR_SamR
SahR_Rhodobacterales	SahR_SamR
SahR_Rhodospirillales	SahR_SamR
SahR_Sphingomonadales	SahR_SamR
SahR_Desulfovibrionales	SahR_SamR
SahR_Desulfuromonadales	SahR_SamR
SahR_Oceanospirillales_Alteromonadales	SahR_SamR
SahR_Pseudomonadaceae	SahR_SamR
SamR_Xanthomonadales	SahR_SamR
SdaR_Clostridia-1	SdaR
SdaR_Enterococcaceae	SdaR
SdaR_Lactobacillaceae	SdaR
SdaR_Rhodospirillales	SdaR
SdaR_Pseudomonadaceae	SdaR
SdaR_Shewanellaceae	SdaR
SdaR_Vibrionales	SdaR
SdaR_Xanthomonadales	SdaR
SdaR_Enterobacteriales	SdaR
SiaR_Enterobacteriales	SiaR
SiaR_Pasteurellales	SiaR
SiaR_Psychromonadaceae_Aeromonadales	SiaR
SiaR_Vibrionales	SiaR
SoxR_Rhizobiales	SoxR
SoxR_Rhodobacterales	SoxR
SoxR_Burkholderia	SoxR
SoxR_Comamonadaceae	SoxR
SoxR_Enterobacteriales	SoxR
SoxR_Pseudomonadaceae	SoxR
SoxR_Vibrionales	SoxR
SoxR_Xanthomonadales	SoxR
SoxR_Rhodospirillales	SoxR
SoxR_Sphingomonadales	SoxR
SoxR_Ralstonia	SoxR
SoxR_Various_betaproteobacteria	SoxR
SoxR_Alteromonadales	SoxR
SoxR_Moraxellaceae	SoxR
SoxR_Oceanospirillales_Alteromonadales	SoxR
SoxR_Psychromonadaceae_Aeromonadales	SoxR
SoxR_Shewanellaceae	SoxR
ThiR_Sulfolobales	ThiR
ThiR_Thermoproteales	ThiR
ThiR_Halobacteriales	ThiR
ThiR_Thermococcales	ThiR
TrpR_Chlamydiales	TrpR
TrpR_Francisellaceae	TrpR
TrpR_Enterobacteriales	TrpR
TrpR_Moraxellaceae	TrpR
TrpR_Oceanospirillales_Alteromonadales	TrpR
TrpR_Pasteurellales	TrpR
TrpR_Psychromonadaceae_Aeromonadales	TrpR
TrpR_Shewanellaceae	TrpR
TrpR_Vibrionales	TrpR
TrpR_Xanthomonadales	TrpR
TtrR_Enterobacteriales	TtrR
TtrR_Pasteurellales	TtrR
TtrR_Shewanellaceae	TtrR
TtrR_Vibrionales	TtrR
TyrR1_Alteromonadales	TyrR
TyrR2_Alteromonadales	TyrR
TyrR_Vibrionales	TyrR
TyrR_Enterobacteriales	TyrR
TyrR_Pasteurellales	TyrR
PhhR_Pseudomonadaceae	TyrR
TyrR_Psychromonadaceae_Aeromonadales	TyrR
TyrR_Shewanellaceae	TyrR
VanR_Alteromonadales	VanR
VanR_Burkholderia	VanR
VanR_Caulobacterales	VanR
VanR_Comamonadaceae	VanR
VanR_Moraxellaceae	VanR
VanR_Oceanospirillales_Alteromonadales	VanR
VanR_Pseudomonadaceae	VanR
VanR_Rhizobiales	VanR
VanR_Xanthomonadales	VanR
XylR_Bacillales	XylR
XylR_Enterococcaceae	XylR
XylR_Lactobacillaceae	XylR
XylR_Rhizobiales	XylR
ZntR_Enterobacteriales	ZntR
ZntR_Oceanospirillales_Alteromonadales	ZntR
ZntR_Psychromonadaceae_Aeromonadales	ZntR
ZntR_Shewanellaceae	ZntR
ZntR_Vibrionales	ZntR
ZntR_Caulobacterales	ZntR
ZntR_Sphingomonadales	ZntR
ZntR_Xanthomonadales	ZntR
Zur_Actinobacteria	Zur
Zur_Bifidobacteriaceae	Zur
Zur_Corynebacteriaceae	Zur
Zur_Frankineae_Propionibacterineae_Pseudonocardiaceae	Zur
Zur_Micrococcineae	Zur
Zur_Mycobacteriaceae	Zur
Zur_Nocardiaceae	Zur
Zur_Streptomycetaceae	Zur
Zur_Bacteroidaceae	Zur
Zur_Chloroflexia	Zur
Zur2_Chloroflexia	Zur
Zur_Cyanobacteria	Zur
Zur_Bacillales	Zur
Zur_Clostridia-1	Zur
Zur_Enterococcaceae	Zur
Zur_Lactobacillaceae	Zur
Zur_Listeriaceae	Zur
Zur_Staphylococcaceae	Zur
Zur_Alteromonadales	Zur
Zur_Burkholderia	Zur
Zur_Caulobacterales	Zur
Zur_Comamonadaceae	Zur
Zur2_Comamonadaceae	Zur
Zur_Moraxellaceae	Zur
Zur_Rhizobiales	Zur
Zur_Rhodobacterales	Zur
Zur_Rhodospirillales	Zur
Zur_Sphingomonadales	Zur
Zur_Various_betaproteobacteria	Zur
Zur2_Various_betaproteobacteria	Zur
Zur_Ralstonia	Zur
Zur_Desulfovibrionales	Zur
Zur_Desulfuromonadales	Zur
Zur_Enterobacteriales	Zur
Zur_Oceanospirillales_Alteromonadales	Zur
Zur_Pseudomonadaceae	Zur
Zur_Psychromonadaceae_Aeromonadales	Zur
Zur_Vibrionales	Zur
Zur_Xanthomonadales	Zur
Zur_Thermotogales	Zur
